#################################################################################################################################
#################################################################################################################################
#################################################################################################################################
#################################################################################################################################
#################################################################################################################################
#####                                                         #####                                                         #####
#####                                                         #####                                                         #####
#####                                                         #####                                                         #####
#####                                                         #####                                                         #####
#####                                                         #####                                                         #####
#####                                                         #####                                                         #####
#####                                                         #####                                                         #####
#####                                                         #####                                                         #####
#####                                                         #####                                                         #####
#####                                                         #####                                                         #####
#####                                                         #####                                                         #####
#####                                                         #####                                                         #####
#####                                                         #####                                                         #####
#####                                                         #####                                                         #####
#####                                                         #####                                                         #####
#####                                                         #####                                                         #####
#####                                                         #####                                                         #####
#####               *                               *         #####         *                               *               #####
#####                                                         #####                                                         #####
#####                                                         #####                                                         #####
#####                                                         #####                                                         #####
#####                   #########################             #####             #########################                   #####
#####                   #########################             #####             #########################                   #####
#####                   #########################             #####             #########################                   #####
#####                   #########################             #####             #########################                   #####
#####                   #########################             #####             #########################                   #####
#####                                                         #####                                                         #####
#####                                                         #####                                                         #####
#####                                                                                                                       #####
#####               *                               *                       *                               *               #####
#####                                                                                                                       #####
#####                                                     *           *                                                     #####
#####                                                                                                                       #####
#####                                                                                                                       #####
#####                                                                                                                       #####
#####                     *           *                                                   *           *                     #####
#####                                                                                                                       #####
#####                                           *                               *                                           #####
#####                                                                                                                       #####
#####                         #####                                                           #####                         #####
#####                         #####                                                           #####                         #####
#####                         #####                 #########################                 #####                         #####
#####                         #####                 #########################                 #####                         #####
#####                         #####                 #########################                 #####                         #####
#####                         #####                 #########################                 #####                         #####
#####                         #####                 #########################                 #####                         #####
#####                         #####                                                           #####                         #####
#####                         #####                                                           #####                         #####
#####                         #####                                                           #####                         #####
#####                         #####             *                               *             #####                         #####
#####                         #####                                                           #####                         #####
#####                         #####                                                           #####                         #####
#####                         #####                                                           #####                         #####
#####               *         #####                                                           #####         *               #####
#####                         #####                                                           #####                         #####
#####                         #####                                                           #####                         #####
#####                         #####                                                           #####                         #####
#################             #####                                                           #####             #################
#################             #####                                                           #####             #################
#################             #####                                                           #####             #################
#################             #####                                                           #####             #################
#################             #####                                                           #####             #################
#####                         #####                                                           #####                         #####
#####                         #####                                                           #####                         #####
#####                         #####                                                           #####                         #####
#####               *         #####                                                           #####         *               #####
#####                         #####                                                           #####                         #####
#####                         #####                                                           #####                         #####
#####                         #####                                                           #####                         #####
#####                         #####             *                               *             #####                         #####
#####                         #####                                                           #####                         #####
#####                         #####                                                           #####                         #####
#####                         #####                                                           #####                         #####
#####                         #####                 #########################                 #####                         #####
#####                         #####                 #########################                 #####                         #####
#####                         #####                 #########################                 #####                         #####
#####                         #####                 #########################                 #####                         #####
#####                         #####                 #########################                 #####                         #####
#####                         #####                                                           #####                         #####
#####                         #####                                                           #####                         #####
#####                                                                                                                       #####
#####                                           *                               *                                           #####
#####                                                                                                                       #####
#####                     *           *                                                   *           *                     #####
#####                                                                                                                       #####
#####                                                                                                                       #####
#####                                                                                                                       #####
#####                                                     *           *                                                     #####
#####                                                                                                                       #####
#####               *                               *                       *                               *               #####
#####                                                                                                                       #####
#####                                                         #####                                                         #####
#####                                                         #####                                                         #####
#####                   #########################             #####             #########################                   #####
#####                   #########################             #####             #########################                   #####
#####                   #########################             #####             #########################                   #####
#####                   #########################             #####             #########################                   #####
#####                   #########################             #####             #########################                   #####
#####                                                         #####                                                         #####
#####                                                         #####                                                         #####
#####                                                         #####                                                         #####
#####               *                               *         #####         *                               *               #####
#####                                                         #####                                                         #####
#####                                                         #####                                                         #####
#####                                                         #####                                                         #####
#####                                                         #####                                                         #####
#####                                                         #####                                                         #####
#####                                                         #####                                                         #####
#####                                                         #####                                                         #####
#####                                                         #####                                                         #####
#####                                                         #####                                                         #####
#####                                                         #####                                                         #####
#####                                                         #####                                                         #####
#####                                                         #####                                                         #####
#####                                                         #####                                                         #####
#####                                                         #####                                                         #####
#####                                                         #####                                                         #####
#####                                                         #####                                                         #####
#####                                                         #####                                                         #####
#################################################################################################################################
#################################################################################################################################
#################################################################################################################################
#################################################################################################################################
#################################################################################################################################